200000800G000000003
1     1  x        1
1 200 1 00003 003 1
1 1   1     1   1 1
1 1 2090003 403 1 1
1 1 1     1   1 1 1
1 1 40000 1 007 1 1
1 1       1   1 1 1
1 400080005 1 1 407
1     1     1 1   1
60000 1 200 60900 1
1     1 1   1     1
1 1 005 60005 200 1
1 1     1     1A  1
1 403 205 203 403 1
1   1 1   1 1   1 1
600 1 1 007 400 1 1
1   1 1  p1     1 1
400090900w400000905