200000800 008000003
1     1  x  1     1
60000 1 200 1 00007
1     1 1   1     1
1 00007 1 0090003 1
1     1 1       1 1
1 203 1 40800 1 1 1
1 1 1 1   1   1 1 1
1 1 1 400 60007 1 1
1   1     1   1   1
6080900 205 1 1 007
1 1     1   1 1   1
1 1 20005 207 603 1
1   1     1 1 1 1 1
600 1 00005 1 1 1 1
1   1       1 1 1 1
1 1 400 20005 1 1 1
1A1     1^    1   1
409000005w000090005