200000000Y008080003
1        x  1 1   1
1 20003 200 1 1 007
1 1   1 1     1  A1
1 1 1 405 2080903 1
1 1 1     1 1   1 1
1 1 6000805 1 1 1 1
1 1 1   1     1   1
605 1 1 1 20005 207
1     1   1     1 1
1 0080a0005 1 005 1
1   1 1     1     1
600 1 1 208090003 1
1     1 1 1     1 1
1 20007 1 1 20805 1
1 1   1 1   1 1   1
1 400 1 403 1 1 007
1     1  p1       1
400000900w400000005