200080000 200000003
1   1    x1       1
1 1 1 200 1 00003 1
1 1 1 1   1     1 1
605 1 1 0090800 407
1   1 1     1     1
1 1 1 40003 1 200 1
1A1 1     1 1 1   1
605 60003 605 403 1
1   1   1 1     1 1
1 205 1 1 1 003 1 1
1 1   1   1   1 1 1
1 1 2090005 205 1 1
1 1 1       1   1 1
1 1 1 2080007 205 1
1 1   1 1   1 1   1
1 1 005 1 1 1 1 007
1       1^1   1   1
400000005w400090005